5 8
8 8 1 1 1 1 1 1
1 8 8 8 8 8 8 1
1 8 1 6 1 1 8 1
1 2 3 1 5 8 8 1
1 1 1 1 1 1 1 1